1111111
1P1C1E1
1000001
1000001
1111111
